********************
*P                 *
*                  *
*                  *
*                  *
*   M              *
*                  *
*                  *
*       G          *
********************